matchday,position,team_name,playedGames,points,goalsFor,goalsAgainst,goalDifference
1,1,VfB Stuttgart,1,3,5,0,5
1,2,FC Bayern München,1,3,4,0,4
1,3,1. FC Union Berlin,1,3,4,1,3
1,4,VfL Wolfsburg,1,3,2,0,2
1,5,Bayer 04 Leverkusen,1,3,3,2,1
1,6,SC Freiburg,1,3,2,1,1
1,7,Borussia Dortmund,1,3,1,0,1
1,8,Eintracht Frankfurt,1,3,1,0,1
1,9,FC Augsburg,1,1,4,4,0
1,10,Borussia Mönchengladbach,1,1,4,4,0
1,11,RB Leipzig,1,0,2,3,-1
1,12,TSG 1899 Hoffenheim,1,0,1,2,-1
1,13,1. FC Köln,1,0,0,1,-1
1,14,SV Darmstadt 98,1,0,0,1,-1
1,15,1. FC Heidenheim 1846,1,0,0,2,-2
1,16,1. FSV Mainz 05,1,0,1,4,-3
1,17,SV Werder Bremen,1,0,0,4,-4
1,18,VfL Bochum 1848,1,0,0,5,-5
1,1,VfB Stuttgart,1,3,5,0,5
1,2,1. FC Union Berlin,1,3,4,1,3
1,3,VfL Wolfsburg,1,3,2,0,2
1,4,Bayer 04 Leverkusen,1,3,3,2,1
1,5,Borussia Dortmund,1,3,1,0,1
1,6,Eintracht Frankfurt,1,3,1,0,1
1,7,FC Augsburg,1,1,4,4,0
1,17,TSG 1899 Hoffenheim,1,0,1,2,-1
1,18,SV Werder Bremen,1,0,0,4,-4
1,1,FC Bayern München,1,3,4,0,4
1,2,SC Freiburg,1,3,2,1,1
1,3,Borussia Mönchengladbach,1,1,4,4,0
1,13,RB Leipzig,1,0,2,3,-1
1,14,1. FC Köln,1,0,0,1,-1
1,15,SV Darmstadt 98,1,0,0,1,-1
1,16,1. FC Heidenheim 1846,1,0,0,2,-2
1,17,1. FSV Mainz 05,1,0,1,4,-3
1,18,VfL Bochum 1848,1,0,0,5,-5
2,1,1. FC Union Berlin,2,6,8,2,6
2,2,FC Bayern München,2,6,7,1,6
2,3,Bayer 04 Leverkusen,2,6,6,2,4
2,4,VfL Wolfsburg,2,6,4,1,3
2,5,SC Freiburg,2,6,3,1,2
2,6,Borussia Dortmund,2,4,2,1,1
2,7,Eintracht Frankfurt,2,4,2,1,1
2,8,RB Leipzig,2,3,7,4,3
2,9,VfB Stuttgart,2,3,6,5,1
2,10,TSG 1899 Hoffenheim,2,3,4,4,0
2,11,FC Augsburg,2,1,5,7,-2
2,12,Borussia Mönchengladbach,2,1,4,7,-3
2,13,1. FSV Mainz 05,2,1,2,5,-3
2,14,VfL Bochum 1848,2,1,1,6,-5
2,15,1. FC Köln,2,0,1,3,-2
2,16,1. FC Heidenheim 1846,2,0,2,5,-3
2,17,SV Darmstadt 98,2,0,1,5,-4
2,18,SV Werder Bremen,2,0,0,5,-5
3,1,Bayer 04 Leverkusen,3,9,11,3,8
3,2,FC Bayern München,3,9,9,2,7
3,3,VfB Stuttgart,3,6,11,5,6
3,4,RB Leipzig,3,6,10,4,6
3,5,1. FC Union Berlin,3,6,8,5,3
3,6,TSG 1899 Hoffenheim,3,6,7,5,2
3,7,VfL Wolfsburg,3,6,5,4,1
3,8,SC Freiburg,3,6,3,6,-3
3,9,Borussia Dortmund,3,5,4,3,1
3,10,Eintracht Frankfurt,3,5,3,2,1
3,11,SV Werder Bremen,3,3,4,5,-1
3,12,FC Augsburg,3,2,7,9,-2
3,13,VfL Bochum 1848,3,2,3,8,-5
3,14,1. FC Köln,3,1,2,4,-2
3,15,1. FC Heidenheim 1846,3,1,4,7,-3
3,16,Borussia Mönchengladbach,3,1,5,9,-4
3,17,1. FSV Mainz 05,3,1,2,9,-7
3,18,SV Darmstadt 98,3,0,2,10,-8
4,1,Bayer 04 Leverkusen,4,10,13,5,8
4,2,FC Bayern München,4,10,11,4,7
4,3,RB Leipzig,4,9,13,4,9
4,4,VfB Stuttgart,4,9,14,6,8
4,5,TSG 1899 Hoffenheim,4,9,10,6,4
4,6,VfL Wolfsburg,4,9,7,5,2
4,7,Borussia Dortmund,4,8,8,5,3
4,8,1. FC Union Berlin,4,6,9,7,2
4,9,Eintracht Frankfurt,4,6,4,3,1
4,10,SC Freiburg,4,6,5,10,-5
4,11,1. FC Heidenheim 1846,4,4,8,9,-1
4,12,SV Werder Bremen,4,3,6,9,-3
4,13,VfL Bochum 1848,4,3,4,9,-5
4,14,Borussia Mönchengladbach,4,2,8,12,-4
4,15,FC Augsburg,4,2,7,12,-5
4,16,1. FC Köln,4,1,3,7,-4
4,17,SV Darmstadt 98,4,1,5,13,-8
4,18,1. FSV Mainz 05,4,1,3,12,-9
5,1,FC Bayern München,5,13,18,4,14
5,2,Bayer 04 Leverkusen,5,13,17,6,11
5,3,VfB Stuttgart,5,12,17,7,10
5,4,RB Leipzig,5,12,14,4,10
5,5,TSG 1899 Hoffenheim,5,12,12,6,6
5,6,Borussia Dortmund,5,11,9,5,4
5,7,VfL Wolfsburg,5,9,7,6,1
5,8,Eintracht Frankfurt,5,7,4,3,1
5,9,SC Freiburg,5,7,5,10,-5
5,10,1. FC Union Berlin,5,6,9,9,0
5,11,SV Werder Bremen,5,6,8,10,-2
5,12,FC Augsburg,5,5,9,13,-4
5,13,1. FC Heidenheim 1846,5,4,9,13,-4
5,14,VfL Bochum 1848,5,3,4,16,-12
5,15,Borussia Mönchengladbach,5,2,8,13,-5
5,16,1. FC Köln,5,1,4,9,-5
5,17,SV Darmstadt 98,5,1,6,16,-10
5,18,1. FSV Mainz 05,5,1,4,14,-10
6,1,Bayer 04 Leverkusen,6,16,20,6,14
6,2,VfB Stuttgart,6,15,19,7,12
6,3,FC Bayern München,6,14,20,6,14
6,4,Borussia Dortmund,6,14,12,6,6
6,5,RB Leipzig,6,13,16,6,10
6,6,TSG 1899 Hoffenheim,6,12,13,9,4
6,7,VfL Wolfsburg,6,12,9,6,3
6,8,SC Freiburg,6,10,7,10,-3
6,9,Eintracht Frankfurt,6,7,4,5,-1
6,10,1. FC Heidenheim 1846,6,7,10,13,-3
6,11,1. FC Union Berlin,6,6,9,10,-1
6,12,SV Werder Bremen,6,6,10,14,-4
6,13,Borussia Mönchengladbach,6,5,11,14,-3
6,14,FC Augsburg,6,5,9,15,-6
6,15,SV Darmstadt 98,6,4,10,18,-8
6,16,VfL Bochum 1848,6,3,5,19,-14
6,17,1. FC Köln,6,1,4,11,-7
6,18,1. FSV Mainz 05,6,1,4,17,-13
7,1,Bayer 04 Leverkusen,7,19,23,6,17
7,2,VfB Stuttgart,7,18,22,8,14
7,3,FC Bayern München,7,17,23,6,17
7,4,Borussia Dortmund,7,17,16,8,8
7,5,TSG 1899 Hoffenheim,7,15,16,11,5
7,6,RB Leipzig,7,14,16,6,10
7,7,VfL Wolfsburg,7,12,10,9,1
7,8,Eintracht Frankfurt,7,10,6,5,1
7,9,SC Freiburg,7,10,7,13,-6
7,10,1. FC Heidenheim 1846,7,7,10,15,-5
7,11,SV Darmstadt 98,7,7,12,19,-7
7,12,Borussia Mönchengladbach,7,6,13,16,-3
7,13,1. FC Union Berlin,7,6,11,14,-3
7,14,SV Werder Bremen,7,6,12,17,-5
7,15,FC Augsburg,7,5,10,17,-7
7,16,VfL Bochum 1848,7,4,5,19,-14
7,17,1. FSV Mainz 05,7,2,6,19,-13
7,18,1. FC Köln,7,1,4,14,-10
8,1,Bayer 04 Leverkusen,8,22,25,7,18
8,2,VfB Stuttgart,8,21,25,8,17
8,3,FC Bayern München,8,20,26,7,19
8,4,Borussia Dortmund,8,20,17,8,9
8,5,RB Leipzig,8,17,19,7,12
8,6,TSG 1899 Hoffenheim,8,15,17,14,3
8,7,Eintracht Frankfurt,8,13,9,6,3
8,8,SC Freiburg,8,13,9,14,-5
8,9,VfL Wolfsburg,8,12,11,11,0
8,10,FC Augsburg,8,8,15,19,-4
8,11,1. FC Heidenheim 1846,8,7,12,20,-8
8,12,SV Darmstadt 98,8,7,13,22,-9
8,13,Borussia Mönchengladbach,8,6,14,19,-5
8,14,SV Werder Bremen,8,6,12,18,-6
8,15,1. FC Union Berlin,8,6,11,17,-6
8,16,1. FC Köln,8,4,7,15,-8
8,17,VfL Bochum 1848,8,4,6,21,-15
8,18,1. FSV Mainz 05,8,2,7,22,-15
9,1,Bayer 04 Leverkusen,9,25,27,8,19
9,2,FC Bayern München,9,23,34,7,27
9,3,VfB Stuttgart,9,21,27,11,16
9,4,Borussia Dortmund,9,21,20,11,9
9,5,RB Leipzig,9,20,25,7,18
9,6,TSG 1899 Hoffenheim,9,18,20,16,4
9,7,Eintracht Frankfurt,9,14,12,9,3
9,8,SC Freiburg,9,13,10,16,-6
9,9,VfL Wolfsburg,9,12,13,14,-1
9,10,FC Augsburg,9,11,18,21,-3
9,11,Borussia Mönchengladbach,9,9,16,20,-4
9,12,SV Werder Bremen,9,9,14,18,-4
9,13,1. FC Heidenheim 1846,9,7,13,22,-9
9,14,SV Darmstadt 98,9,7,13,30,-17
9,15,1. FC Union Berlin,9,6,11,19,-8
9,16,VfL Bochum 1848,9,5,8,23,-15
9,17,1. FC Köln,9,4,7,21,-14
9,18,1. FSV Mainz 05,9,3,9,24,-15
10,1,Bayer 04 Leverkusen,10,28,30,10,20
10,2,FC Bayern München,10,26,38,7,31
10,3,VfB Stuttgart,10,21,27,13,14
10,4,Borussia Dortmund,10,21,20,15,5
10,5,RB Leipzig,10,20,25,9,16
10,6,TSG 1899 Hoffenheim,10,18,22,19,3
10,7,Eintracht Frankfurt,10,17,15,9,6
10,8,SC Freiburg,10,14,13,19,-6
10,9,VfL Wolfsburg,10,13,15,16,-1
10,10,FC Augsburg,10,12,19,22,-3
10,11,Borussia Mönchengladbach,10,10,19,23,-4
10,12,SV Werder Bremen,10,10,16,20,-4
10,13,1. FC Heidenheim 1846,10,10,15,22,-7
10,14,VfL Bochum 1848,10,8,10,24,-14
10,15,SV Darmstadt 98,10,7,14,32,-18
10,16,1. FC Union Berlin,10,6,11,22,-11
10,17,1. FSV Mainz 05,10,6,11,24,-13
10,18,1. FC Köln,10,5,8,22,-14
11,1,Bayer 04 Leverkusen,11,31,34,10,24
11,2,FC Bayern München,11,29,42,9,33
11,3,VfB Stuttgart,11,24,29,14,15
11,4,RB Leipzig,11,23,28,10,18
11,5,Borussia Dortmund,11,21,21,17,4
11,6,TSG 1899 Hoffenheim,11,19,23,20,3
11,7,Eintracht Frankfurt,11,18,17,11,6
11,8,SC Freiburg,11,14,14,22,-8
11,9,Borussia Mönchengladbach,11,13,23,23,0
11,10,FC Augsburg,11,13,20,23,-3
11,11,VfL Wolfsburg,11,13,15,20,-5
11,12,SV Werder Bremen,11,11,18,22,-4
11,13,1. FC Heidenheim 1846,11,10,17,26,-9
11,14,VfL Bochum 1848,11,9,11,25,-14
11,15,SV Darmstadt 98,11,8,14,32,-18
11,16,1. FSV Mainz 05,11,7,11,24,-13
11,17,1. FC Köln,11,6,9,23,-14
11,18,1. FC Union Berlin,11,6,11,26,-15
12,1,Bayer 04 Leverkusen,12,34,37,10,27
12,2,FC Bayern München,12,32,43,9,34
12,3,VfB Stuttgart,12,27,31,15,16
12,4,Borussia Dortmund,12,24,25,19,6
12,5,RB Leipzig,12,23,29,12,17
12,6,TSG 1899 Hoffenheim,12,20,24,21,3
12,7,Eintracht Frankfurt,12,18,18,13,5
12,8,VfL Wolfsburg,12,16,17,21,-4
12,9,SC Freiburg,12,15,15,23,-8
12,10,FC Augsburg,12,14,21,24,-3
12,11,Borussia Mönchengladbach,12,13,25,27,-2
12,12,SV Werder Bremen,12,11,18,25,-7
12,13,1. FC Heidenheim 1846,12,11,17,26,-9
12,14,VfL Bochum 1848,12,10,11,25,-14
12,15,SV Darmstadt 98,12,9,15,33,-18
12,16,1. FSV Mainz 05,12,8,12,25,-13
12,17,1. FC Union Berlin,12,7,12,27,-15
12,18,1. FC Köln,12,6,9,24,-15
13,1,FC Bayern München,13,35,44,9,35
13,2,Bayer 04 Leverkusen,13,35,38,11,27
13,3,VfB Stuttgart,13,30,33,15,18
13,4,RB Leipzig,13,26,31,13,18
13,5,Borussia Dortmund,13,25,26,20,6
13,6,TSG 1899 Hoffenheim,13,20,25,23,2
13,7,Eintracht Frankfurt,13,18,19,15,4
13,8,SC Freiburg,13,18,16,23,-7
13,9,FC Augsburg,13,17,23,25,-2
13,10,Borussia Mönchengladbach,13,16,27,28,-1
13,11,VfL Wolfsburg,13,16,18,24,-6
13,12,VfL Bochum 1848,13,13,14,26,-12
13,13,SV Werder Bremen,13,11,18,27,-9
13,14,1. FC Heidenheim 1846,13,11,18,28,-10
13,15,1. FC Köln,13,9,10,24,-14
13,16,SV Darmstadt 98,13,9,15,34,-19
13,17,1. FSV Mainz 05,13,8,12,26,-14
13,18,1. FC Union Berlin,13,7,12,28,-16
14,1,Bayer 04 Leverkusen,14,36,39,12,27
14,2,FC Bayern München,14,35,45,14,31
14,3,VfB Stuttgart,14,31,34,16,18
14,4,RB Leipzig,14,29,34,15,19
14,5,Borussia Dortmund,14,25,28,23,5
14,6,TSG 1899 Hoffenheim,14,23,28,24,4
14,7,Eintracht Frankfurt,14,21,24,16,8
14,8,SC Freiburg,14,21,17,23,-6
14,9,FC Augsburg,14,17,23,27,-4
14,10,Borussia Mönchengladbach,14,16,28,31,-3
14,11,VfL Wolfsburg,14,16,18,25,-7
14,12,SV Werder Bremen,14,14,20,27,-7
14,13,1. FC Heidenheim 1846,14,14,21,30,-9
14,14,VfL Bochum 1848,14,13,15,29,-14
14,15,1. FC Union Berlin,14,10,15,29,-14
14,16,1. FC Köln,14,10,10,24,-14
14,17,1. FSV Mainz 05,14,9,12,26,-14
14,18,SV Darmstadt 98,14,9,17,37,-20
15,1,Bayer 04 Leverkusen,15,39,42,12,30
15,2,FC Bayern München,15,38,48,14,34
15,3,RB Leipzig,15,32,37,16,21
15,4,VfB Stuttgart,15,31,34,19,15
15,5,Borussia Dortmund,15,26,29,24,5
15,6,SC Freiburg,15,24,19,23,-4
15,7,TSG 1899 Hoffenheim,15,23,29,27,2
15,8,Eintracht Frankfurt,15,21,24,19,5
15,9,VfL Wolfsburg,15,19,19,25,-6
15,10,FC Augsburg,15,18,24,28,-4
15,11,Borussia Mönchengladbach,15,17,30,33,-3
15,12,1. FC Heidenheim 1846,15,17,22,30,-8
15,13,VfL Bochum 1848,15,16,18,29,-11
15,14,SV Werder Bremen,15,15,22,29,-7
15,15,1. FC Köln,15,10,10,26,-16
15,16,1. FC Union Berlin,15,10,15,32,-17
15,17,1. FSV Mainz 05,15,9,12,27,-15
15,18,SV Darmstadt 98,15,9,17,38,-21
16,1,Bayer 04 Leverkusen,16,42,46,12,34
16,2,FC Bayern München,16,41,50,15,35
16,3,VfB Stuttgart,16,34,37,19,18
16,4,RB Leipzig,16,33,38,17,21
16,5,Borussia Dortmund,16,27,30,25,5
16,6,Eintracht Frankfurt,16,24,26,20,6
16,7,TSG 1899 Hoffenheim,16,24,32,30,2
16,8,SC Freiburg,16,24,21,26,-5
16,9,1. FC Heidenheim 1846,16,20,25,32,-7
16,10,VfL Wolfsburg,16,19,20,27,-7
16,11,FC Augsburg,16,18,24,31,-7
16,12,Borussia Mönchengladbach,16,17,31,35,-4
16,13,SV Werder Bremen,16,16,23,30,-7
16,14,VfL Bochum 1848,16,16,18,33,-15
16,15,1. FC Union Berlin,16,13,17,32,-15
16,16,1. FSV Mainz 05,16,10,13,28,-15
16,17,1. FC Köln,16,10,10,28,-18
16,18,SV Darmstadt 98,16,10,20,41,-21
17,1,Bayer 04 Leverkusen,17,45,47,12,35
17,2,FC Bayern München,17,44,53,15,38
17,3,VfB Stuttgart,17,34,38,22,16
17,4,RB Leipzig,17,33,38,18,20
17,5,Borussia Dortmund,17,30,33,25,8
17,6,Eintracht Frankfurt,17,27,27,20,7
17,7,SC Freiburg,17,25,21,26,-5
17,8,TSG 1899 Hoffenheim,17,24,32,33,-1
17,9,1. FC Heidenheim 1846,17,21,26,33,-7
17,10,Borussia Mönchengladbach,17,20,34,36,-2
17,11,VfL Wolfsburg,17,20,21,28,-7
17,12,FC Augsburg,17,18,24,32,-8
17,13,SV Werder Bremen,17,17,24,31,-7
17,14,VfL Bochum 1848,17,17,19,34,-15
17,15,1. FC Union Berlin,17,14,17,32,-15
17,16,1. FSV Mainz 05,17,11,14,29,-15
17,17,1. FC Köln,17,11,11,29,-18
17,18,SV Darmstadt 98,17,10,20,44,-24
18,1,Bayer 04 Leverkusen,18,48,50,14,36
18,2,FC Bayern München,18,44,53,16,37
18,3,VfB Stuttgart,18,34,38,23,15
18,4,RB Leipzig,18,33,40,21,19
18,5,Borussia Dortmund,18,33,37,25,12
18,6,Eintracht Frankfurt,18,28,29,22,7
18,7,SC Freiburg,18,28,24,28,-4
18,8,TSG 1899 Hoffenheim,18,24,34,36,-2
18,9,1. FC Heidenheim 1846,18,22,27,34,-7
18,10,FC Augsburg,18,21,26,33,-7
18,11,VfL Wolfsburg,18,21,22,29,-7
18,12,Borussia Mönchengladbach,18,20,35,38,-3
18,13,SV Werder Bremen,18,20,25,31,-6
18,14,VfL Bochum 1848,18,20,20,34,-14
18,15,1. FC Union Berlin,18,15,18,33,-15
18,16,1. FSV Mainz 05,18,12,15,30,-15
18,17,1. FC Köln,18,11,11,33,-22
18,18,SV Darmstadt 98,18,11,22,46,-24
19,1,Bayer 04 Leverkusen,19,49,50,14,36
19,2,FC Bayern München,19,47,56,18,38
19,3,VfB Stuttgart,19,37,43,25,18
19,4,Borussia Dortmund,19,36,40,26,14
19,5,RB Leipzig,19,33,42,26,16
19,6,Eintracht Frankfurt,19,31,30,22,8
19,7,SC Freiburg,19,28,25,31,-6
19,8,TSG 1899 Hoffenheim,19,25,35,37,-2
19,9,SV Werder Bremen,19,23,28,32,-4
19,10,1. FC Heidenheim 1846,19,23,28,35,-7
19,11,VfL Wolfsburg,19,22,23,30,-7
19,12,Borussia Mönchengladbach,19,21,35,38,-3
19,13,FC Augsburg,19,21,28,36,-8
19,14,VfL Bochum 1848,19,20,21,37,-16
19,15,1. FC Union Berlin,19,18,19,33,-14
19,16,1. FSV Mainz 05,19,12,15,31,-16
19,17,1. FC Köln,19,12,12,34,-22
19,18,SV Darmstadt 98,19,11,22,47,-25
20,1,Bayer 04 Leverkusen,20,52,52,14,38
20,2,FC Bayern München,20,50,59,19,40
20,3,VfB Stuttgart,20,40,46,26,20
20,4,Borussia Dortmund,20,37,40,26,14
20,5,RB Leipzig,20,36,44,26,18
20,6,Eintracht Frankfurt,20,31,30,24,6
20,7,SC Freiburg,20,28,26,34,-8
20,8,TSG 1899 Hoffenheim,20,26,37,39,-2
20,9,SV Werder Bremen,20,26,29,32,-3
20,10,1. FC Heidenheim 1846,20,24,28,35,-7
20,11,VfL Wolfsburg,20,23,25,32,-7
20,12,FC Augsburg,20,22,29,37,-8
20,13,Borussia Mönchengladbach,20,21,36,41,-5
20,14,VfL Bochum 1848,20,21,22,38,-16
20,15,1. FC Union Berlin,20,18,19,35,-16
20,16,1. FC Köln,20,15,14,34,-20
20,17,1. FSV Mainz 05,20,12,15,32,-17
20,18,SV Darmstadt 98,20,11,22,49,-27
21,1,Bayer 04 Leverkusen,21,55,55,14,41
21,2,FC Bayern München,21,50,59,22,37
21,3,VfB Stuttgart,21,43,49,27,22
21,4,Borussia Dortmund,21,40,43,26,17
21,5,RB Leipzig,21,37,46,28,18
21,6,Eintracht Frankfurt,21,32,31,25,6
21,7,SC Freiburg,21,28,26,37,-11
21,8,TSG 1899 Hoffenheim,21,27,38,40,-2
21,9,1. FC Heidenheim 1846,21,27,30,36,-6
21,10,SV Werder Bremen,21,26,30,34,-4
21,11,FC Augsburg,21,23,31,39,-8
21,12,VfL Wolfsburg,21,23,25,33,-8
21,13,Borussia Mönchengladbach,21,22,36,41,-5
21,14,VfL Bochum 1848,21,22,23,39,-16
21,15,1. FC Union Berlin,21,21,20,35,-15
21,16,1. FC Köln,21,16,15,35,-20
21,17,1. FSV Mainz 05,21,12,16,35,-19
21,18,SV Darmstadt 98,21,12,22,49,-27
22,1,Bayer 04 Leverkusen,22,58,57,15,42
22,2,FC Bayern München,22,50,61,25,36
22,3,VfB Stuttgart,22,46,51,28,23
22,4,Borussia Dortmund,22,41,44,27,17
22,5,RB Leipzig,22,40,48,28,20
22,6,Eintracht Frankfurt,22,33,34,28,6
22,7,SV Werder Bremen,22,29,31,34,-3
22,8,SC Freiburg,22,29,29,40,-11
22,9,TSG 1899 Hoffenheim,22,27,38,41,-3
22,10,1. FC Heidenheim 1846,22,27,31,38,-7
22,11,VfL Bochum 1848,22,25,26,41,-15
22,12,VfL Wolfsburg,22,24,26,34,-8
22,13,1. FC Union Berlin,22,24,21,35,-14
22,14,FC Augsburg,22,23,31,40,-9
22,15,Borussia Mönchengladbach,22,22,36,43,-7
22,16,1. FC Köln,22,16,15,36,-21
22,17,1. FSV Mainz 05,22,15,17,35,-18
22,18,SV Darmstadt 98,22,12,23,51,-28
23,1,Bayer 04 Leverkusen,23,61,59,16,43
23,2,FC Bayern München,23,53,63,26,37
23,3,VfB Stuttgart,23,47,52,29,23
23,4,Borussia Dortmund,23,41,46,30,16
23,5,RB Leipzig,23,40,49,30,19
23,6,Eintracht Frankfurt,23,34,36,30,6
23,7,TSG 1899 Hoffenheim,23,30,41,43,-2
23,8,SV Werder Bremen,23,30,32,35,-3
23,9,SC Freiburg,23,29,30,42,-12
23,10,1. FC Heidenheim 1846,23,28,33,40,-7
23,11,FC Augsburg,23,26,33,41,-8
23,12,Borussia Mönchengladbach,23,25,41,45,-4
23,13,VfL Wolfsburg,23,25,28,36,-8
23,14,1. FC Union Berlin,23,25,23,37,-14
23,15,VfL Bochum 1848,23,25,28,46,-18
23,16,1. FC Köln,23,17,16,37,-21
23,17,1. FSV Mainz 05,23,15,18,37,-19
23,18,SV Darmstadt 98,23,13,24,52,-28
24,1,Bayer 04 Leverkusen,24,64,61,16,45
24,2,FC Bayern München,24,54,65,28,37
24,3,VfB Stuttgart,24,50,55,31,24
24,4,Borussia Dortmund,24,44,48,30,18
24,5,RB Leipzig,24,43,53,31,22
24,6,Eintracht Frankfurt,24,37,38,31,7
24,7,TSG 1899 Hoffenheim,24,33,43,44,-1
24,8,SV Werder Bremen,24,30,33,37,-4
24,9,SC Freiburg,24,30,32,44,-12
24,10,FC Augsburg,24,29,39,41,-2
24,11,1. FC Heidenheim 1846,24,28,34,42,-8
24,12,Borussia Mönchengladbach,24,26,42,46,-4
24,13,VfL Wolfsburg,24,25,30,39,-9
24,14,1. FC Union Berlin,24,25,23,39,-16
24,15,VfL Bochum 1848,24,25,29,50,-21
24,16,1. FC Köln,24,17,16,39,-23
24,17,1. FSV Mainz 05,24,16,19,38,-19
24,18,SV Darmstadt 98,24,13,24,58,-34
25,1,Bayer 04 Leverkusen,25,67,63,16,47
25,2,FC Bayern München,25,57,73,29,44
25,3,VfB Stuttgart,25,53,57,31,26
25,4,Borussia Dortmund,25,47,50,31,19
25,5,RB Leipzig,25,46,55,31,24
25,6,Eintracht Frankfurt,25,40,41,32,9
25,7,TSG 1899 Hoffenheim,25,33,44,47,-3
25,8,SC Freiburg,25,33,34,45,-11
25,9,FC Augsburg,25,32,40,41,-1
25,10,SV Werder Bremen,25,30,34,39,-5
25,11,1. FC Heidenheim 1846,25,28,34,43,-9
25,12,Borussia Mönchengladbach,25,27,45,49,-4
25,13,VfL Wolfsburg,25,25,30,41,-11
25,14,1. FC Union Berlin,25,25,23,41,-18
25,15,VfL Bochum 1848,25,25,30,52,-22
25,16,1. FC Köln,25,18,19,42,-23
25,17,1. FSV Mainz 05,25,16,20,46,-26
25,18,SV Darmstadt 98,25,13,24,60,-36
26,1,Bayer 04 Leverkusen,26,70,66,18,48
26,2,FC Bayern München,26,60,78,31,47
26,3,VfB Stuttgart,26,56,60,31,29
26,4,Borussia Dortmund,26,50,53,32,21
26,5,RB Leipzig,26,49,60,32,28
26,6,Eintracht Frankfurt,26,40,42,35,7
26,7,FC Augsburg,26,35,43,42,1
26,8,TSG 1899 Hoffenheim,26,33,44,50,-6
26,9,SC Freiburg,26,33,36,48,-12
26,10,SV Werder Bremen,26,30,35,41,-6
26,11,1. FC Heidenheim 1846,26,29,35,44,-9
26,12,Borussia Mönchengladbach,26,28,46,50,-4
26,13,1. FC Union Berlin,26,28,25,42,-17
26,14,VfL Wolfsburg,26,25,31,44,-13
26,15,VfL Bochum 1848,26,25,30,54,-24
26,16,1. FSV Mainz 05,26,19,22,46,-24
26,17,1. FC Köln,26,18,20,47,-27
26,18,SV Darmstadt 98,26,13,26,65,-39
27,1,Bayer 04 Leverkusen,27,73,68,19,49
27,2,FC Bayern München,27,60,78,33,45
27,3,VfB Stuttgart,27,57,63,34,29
27,4,Borussia Dortmund,27,53,55,32,23
27,5,RB Leipzig,27,50,60,32,28
27,6,Eintracht Frankfurt,27,41,42,35,7
27,7,FC Augsburg,27,36,44,43,1
27,8,SC Freiburg,27,36,39,48,-9
27,9,TSG 1899 Hoffenheim,27,33,45,52,-7
27,10,SV Werder Bremen,27,30,35,43,-8
27,11,1. FC Heidenheim 1846,27,30,38,47,-9
27,12,1. FC Union Berlin,27,29,25,42,-17
27,13,Borussia Mönchengladbach,27,28,46,53,-7
27,14,VfL Wolfsburg,27,28,33,44,-11
27,15,VfL Bochum 1848,27,26,32,56,-24
27,16,1. FSV Mainz 05,27,20,22,46,-24
27,17,1. FC Köln,27,19,21,48,-27
27,18,SV Darmstadt 98,27,14,28,67,-39
28,1,Bayer 04 Leverkusen,28,76,69,19,50
28,2,FC Bayern München,28,60,80,36,44
28,3,VfB Stuttgart,28,60,64,34,30
28,4,RB Leipzig,28,53,64,33,31
28,5,Borussia Dortmund,28,53,55,33,22
28,6,Eintracht Frankfurt,28,42,43,36,7
28,7,FC Augsburg,28,36,45,46,-1
28,8,TSG 1899 Hoffenheim,28,36,48,53,-5
28,9,SC Freiburg,28,36,40,52,-12
28,10,1. FC Heidenheim 1846,28,33,41,49,-8
28,11,Borussia Mönchengladbach,28,31,49,54,-5
28,12,SV Werder Bremen,28,31,36,44,-8
28,13,1. FC Union Berlin,28,29,25,43,-18
28,14,VfL Wolfsburg,28,28,34,47,-13
28,15,VfL Bochum 1848,28,26,33,58,-25
28,16,1. FSV Mainz 05,28,23,26,46,-20
28,17,1. FC Köln,28,22,23,49,-26
28,18,SV Darmstadt 98,28,14,28,71,-43
29,1,Bayer 04 Leverkusen,29,79,74,19,55
29,2,FC Bayern München,29,63,82,36,46
29,3,VfB Stuttgart,29,63,67,34,33
29,4,RB Leipzig,29,56,67,33,34
29,5,Borussia Dortmund,29,56,57,34,23
29,6,Eintracht Frankfurt,29,42,43,39,4
29,7,FC Augsburg,29,39,47,46,1
29,8,SC Freiburg,29,39,41,52,-11
29,9,TSG 1899 Hoffenheim,29,36,49,57,-8
29,10,1. FC Heidenheim 1846,29,34,42,50,-8
29,11,Borussia Mönchengladbach,29,31,50,56,-6
29,12,SV Werder Bremen,29,31,36,49,-13
29,13,1. FC Union Berlin,29,29,25,45,-20
29,14,VfL Wolfsburg,29,28,34,50,-16
29,15,VfL Bochum 1848,29,27,34,59,-25
29,16,1. FSV Mainz 05,29,26,30,47,-17
29,17,1. FC Köln,29,22,23,51,-28
29,18,SV Darmstadt 98,29,14,28,72,-44
30,1,Bayer 04 Leverkusen,30,80,75,20,55
30,2,FC Bayern München,30,66,87,37,50
30,3,VfB Stuttgart,30,63,68,36,32
30,4,RB Leipzig,30,59,69,34,35
30,5,Borussia Dortmund,30,57,58,35,23
30,6,Eintracht Frankfurt,30,45,46,40,6
30,7,SC Freiburg,30,40,42,53,-11
30,8,FC Augsburg,30,39,48,49,-1
30,9,TSG 1899 Hoffenheim,30,39,53,60,-7
30,10,1. FC Heidenheim 1846,30,34,43,52,-9
30,11,SV Werder Bremen,30,34,38,50,-12
30,12,Borussia Mönchengladbach,30,31,53,60,-7
30,13,VfL Wolfsburg,30,31,35,50,-15
30,14,1. FC Union Berlin,30,29,26,50,-24
30,15,1. FSV Mainz 05,30,27,31,48,-17
30,16,VfL Bochum 1848,30,27,34,60,-26
30,17,1. FC Köln,30,22,23,53,-30
30,18,SV Darmstadt 98,30,17,30,72,-42
31,1,Bayer 04 Leverkusen,31,81,77,22,55
31,2,FC Bayern München,31,69,89,38,51
31,3,VfB Stuttgart,31,64,70,38,32
31,4,RB Leipzig,31,62,73,35,38
31,5,Borussia Dortmund,31,57,59,39,20
31,6,Eintracht Frankfurt,31,45,47,42,5
31,7,SC Freiburg,31,40,43,55,-12
31,8,FC Augsburg,31,39,48,52,-4
31,9,TSG 1899 Hoffenheim,31,39,55,63,-8
31,10,1. FC Heidenheim 1846,31,37,44,52,-8
31,11,SV Werder Bremen,31,37,41,50,-9
31,12,VfL Wolfsburg,31,34,37,51,-14
31,13,Borussia Mönchengladbach,31,32,53,60,-7
31,14,1. FC Union Berlin,31,30,26,50,-24
31,15,VfL Bochum 1848,31,30,37,62,-25
31,16,1. FSV Mainz 05,31,28,32,49,-17
31,17,1. FC Köln,31,23,24,54,-30
31,18,SV Darmstadt 98,31,17,30,73,-43
32,1,Bayer 04 Leverkusen,32,84,82,23,59
32,2,FC Bayern München,32,69,90,41,49
32,3,VfB Stuttgart,32,67,73,39,34
32,4,RB Leipzig,32,63,74,36,38
32,5,Borussia Dortmund,32,60,64,40,24
32,6,Eintracht Frankfurt,32,45,48,47,1
32,7,SC Freiburg,32,41,43,55,-12
32,8,TSG 1899 Hoffenheim,32,40,56,64,-8
32,9,FC Augsburg,32,39,49,57,-8
32,10,1. FC Heidenheim 1846,32,38,45,53,-8
32,11,SV Werder Bremen,32,38,43,52,-9
32,12,VfL Wolfsburg,32,37,40,51,-11
32,13,Borussia Mönchengladbach,32,33,55,62,-7
32,14,VfL Bochum 1848,32,33,41,65,-24
32,15,1. FC Union Berlin,32,30,29,54,-25
32,16,1. FSV Mainz 05,32,29,33,50,-17
32,17,1. FC Köln,32,24,24,54,-30
32,18,SV Darmstadt 98,32,17,30,76,-46
33,1,Bayer 04 Leverkusen,33,87,87,23,64
33,2,FC Bayern München,33,72,92,41,51
33,3,VfB Stuttgart,33,70,74,39,35
33,4,RB Leipzig,33,64,75,37,38
33,5,Borussia Dortmund,33,60,64,43,21
33,6,Eintracht Frankfurt,33,46,49,48,1
33,7,TSG 1899 Hoffenheim,33,43,62,64,-2
33,8,SC Freiburg,33,42,44,56,-12
33,9,1. FC Heidenheim 1846,33,39,46,54,-8
33,10,FC Augsburg,33,39,49,58,-9
33,11,SV Werder Bremen,33,39,44,53,-9
33,12,VfL Wolfsburg,33,37,40,53,-13
33,13,Borussia Mönchengladbach,33,34,56,63,-7
33,14,VfL Bochum 1848,33,33,41,70,-29
33,15,1. FSV Mainz 05,33,32,36,50,-14
33,16,1. FC Union Berlin,33,30,31,57,-26
33,17,1. FC Köln,33,27,27,56,-29
33,18,SV Darmstadt 98,33,17,30,82,-52
34,1,Bayer 04 Leverkusen,34,90,89,24,65
34,2,VfB Stuttgart,34,73,78,39,39
34,3,FC Bayern München,34,72,94,45,49
34,4,RB Leipzig,34,65,77,39,38
34,5,Borussia Dortmund,34,63,68,43,25
34,6,Eintracht Frankfurt,34,47,51,50,1
34,7,TSG 1899 Hoffenheim,34,46,66,66,0
34,8,1. FC Heidenheim 1846,34,42,50,55,-5
34,9,SV Werder Bremen,34,42,48,54,-6
34,10,SC Freiburg,34,42,45,58,-13
34,11,FC Augsburg,34,39,50,60,-10
34,12,VfL Wolfsburg,34,37,41,56,-15
34,13,1. FSV Mainz 05,34,35,39,51,-12
34,14,Borussia Mönchengladbach,34,34,56,67,-11
34,15,1. FC Union Berlin,34,33,33,58,-25
34,16,VfL Bochum 1848,34,33,42,74,-32
34,17,1. FC Köln,34,27,28,60,-32
34,18,SV Darmstadt 98,34,17,30,86,-56
