matchday,position,team_name,playedGames,points,goalsFor,goalsAgainst,goalDifference
1,1,Paris Saint-Germain FC,1,3,5,0,5
1,2,Lille OSC,1,3,4,1,3
1,3,Olympique de Marseille,1,3,4,1,3
1,4,Racing Club de Lens,1,3,3,2,1
1,5,Montpellier HSC,1,3,3,2,1
1,6,Olympique Lyonnais,1,3,2,1,1
1,7,AS Monaco FC,1,3,2,1,1
1,8,FC Lorient,1,3,1,0,1
1,9,Toulouse FC,1,1,1,1,0
1,10,OGC Nice,1,1,1,1,0
1,11,Angers SCO,1,1,0,0,0
1,12,FC Nantes,1,1,0,0,0
1,13,Stade Brestois 29,1,0,2,3,-1
1,14,ES Troyes AC,1,0,2,3,-1
1,15,AC Ajaccio,1,0,1,2,-1
1,16,RC Strasbourg Alsace,1,0,1,2,-1
1,17,Stade Rennais FC 1901,1,0,0,1,-1
1,18,AJ Auxerre,1,0,1,4,-3
1,19,Stade de Reims,1,0,1,4,-3
1,20,Clermont Foot 63,1,0,0,5,-5
1,1,Lille OSC,1,3,4,1,3
1,2,Olympique de Marseille,1,3,4,1,3
1,3,Racing Club de Lens,1,3,3,2,1
1,4,Montpellier HSC,1,3,3,2,1
1,5,Olympique Lyonnais,1,3,2,1,1
1,6,Toulouse FC,1,1,1,1,0
1,7,Angers SCO,1,1,0,0,0
1,18,RC Strasbourg Alsace,1,0,1,2,-1
1,19,Stade Rennais FC 1901,1,0,0,1,-1
1,20,Clermont Foot 63,1,0,0,5,-5
1,1,Paris Saint-Germain FC,1,3,5,0,5
1,2,AS Monaco FC,1,3,2,1,1
1,3,FC Lorient,1,3,1,0,1
1,4,OGC Nice,1,1,1,1,0
1,5,FC Nantes,1,1,0,0,0
1,16,Stade Brestois 29,1,0,2,3,-1
1,17,ES Troyes AC,1,0,2,3,-1
1,18,AC Ajaccio,1,0,1,2,-1
1,19,AJ Auxerre,1,0,1,4,-3
1,20,Stade de Reims,1,0,1,4,-3
2,1,Paris Saint-Germain FC,2,6,10,2,8
2,2,FC Lorient,2,6,4,1,3
2,3,Lille OSC,2,4,5,2,3
2,4,Olympique de Marseille,2,4,5,2,3
2,5,Toulouse FC,2,4,4,1,3
2,6,AS Monaco FC,2,4,3,2,1
2,7,Racing Club de Lens,2,4,3,2,1
2,8,Olympique Lyonnais,2,3,3,4,-1
2,9,Montpellier HSC,2,3,5,7,-2
2,10,Clermont Foot 63,2,3,4,7,-3
2,11,OGC Nice,2,2,2,2,0
2,12,Angers SCO,2,2,2,2,0
2,13,FC Nantes,2,2,1,1,0
2,14,Stade Brestois 29,2,1,3,4,-1
2,15,RC Strasbourg Alsace,2,1,2,3,-1
2,16,AC Ajaccio,2,1,1,2,-1
2,17,Stade Rennais FC 1901,2,1,1,2,-1
2,18,AJ Auxerre,2,1,3,6,-3
2,19,ES Troyes AC,2,0,2,6,-4
2,20,Stade de Reims,2,0,3,8,-5
3,1,Paris Saint-Germain FC,3,9,17,3,14
3,2,Racing Club de Lens,3,7,7,3,4
3,3,Olympique de Marseille,3,7,7,3,4
3,4,FC Lorient,3,7,6,3,3
3,5,Olympique Lyonnais,3,6,7,5,2
3,6,Clermont Foot 63,3,6,5,7,-2
3,7,Toulouse FC,3,5,6,3,3
3,8,Stade Brestois 29,3,4,6,5,1
3,9,Stade Rennais FC 1901,3,4,3,3,0
3,10,AJ Auxerre,3,4,5,7,-2
3,11,AS Monaco FC,3,4,4,6,-2
3,12,Lille OSC,3,4,6,9,-3
3,13,Montpellier HSC,3,3,6,9,-3
3,14,RC Strasbourg Alsace,3,2,3,4,-1
3,15,OGC Nice,3,2,2,3,-1
3,16,FC Nantes,3,2,2,3,-1
3,17,Angers SCO,3,2,3,5,-2
3,18,AC Ajaccio,3,1,2,4,-2
3,19,Stade de Reims,3,1,4,9,-5
3,20,ES Troyes AC,3,0,3,10,-7
4,1,Paris Saint-Germain FC,4,10,18,4,14
4,2,Olympique de Marseille,4,10,10,3,7
4,3,Racing Club de Lens,4,10,9,4,5
4,4,FC Lorient,4,10,8,4,4
4,5,Olympique Lyonnais,4,7,8,6,2
4,6,Lille OSC,4,7,9,10,-1
4,7,AJ Auxerre,4,7,6,7,-1
4,8,Montpellier HSC,4,6,13,9,4
4,9,Clermont Foot 63,4,6,6,9,-3
4,10,Toulouse FC,4,5,7,6,1
4,11,FC Nantes,4,5,5,4,1
4,12,AS Monaco FC,4,5,5,7,-2
4,13,Stade Rennais FC 1901,4,4,4,5,-1
4,14,Stade Brestois 29,4,4,6,12,-6
4,15,ES Troyes AC,4,3,6,11,-5
4,16,RC Strasbourg Alsace,4,2,3,5,-2
4,17,Angers SCO,4,2,4,8,-4
4,18,OGC Nice,4,2,2,6,-4
4,19,Stade de Reims,4,2,5,10,-5
4,20,AC Ajaccio,4,1,3,7,-4
5,1,Paris Saint-Germain FC,5,13,21,4,17
5,2,Racing Club de Lens,5,13,14,6,8
5,3,Olympique de Marseille,5,13,11,3,8
5,4,Olympique Lyonnais,5,10,10,7,3
5,5,FC Lorient,5,10,10,9,1
5,6,Montpellier HSC,5,9,15,9,6
5,7,Stade Rennais FC 1901,5,7,7,6,1
5,8,Lille OSC,5,7,10,12,-2
5,9,AJ Auxerre,5,7,7,9,-2
5,10,FC Nantes,5,6,6,5,1
5,11,ES Troyes AC,5,6,10,13,-3
5,12,Clermont Foot 63,5,6,6,10,-4
5,13,Toulouse FC,5,5,7,9,-2
5,14,Stade de Reims,5,5,9,12,-3
5,15,OGC Nice,5,5,4,7,-3
5,16,AS Monaco FC,5,5,7,11,-4
5,17,Stade Brestois 29,5,4,7,15,-8
5,18,RC Strasbourg Alsace,5,3,4,6,-2
5,19,Angers SCO,5,2,6,12,-6
5,20,AC Ajaccio,5,1,3,9,-6
6,1,Paris Saint-Germain FC,6,16,24,4,20
6,2,Olympique de Marseille,6,16,13,3,10
6,3,Racing Club de Lens,6,14,15,7,8
6,4,Olympique Lyonnais,6,13,15,7,8
6,5,FC Lorient,6,13,11,9,2
6,6,Lille OSC,6,10,13,13,0
6,7,Montpellier HSC,6,9,16,12,4
6,8,Clermont Foot 63,6,9,8,10,-2
6,9,Stade Rennais FC 1901,6,8,8,7,1
6,10,AS Monaco FC,6,8,8,11,-3
6,11,ES Troyes AC,6,7,11,14,-3
6,12,AJ Auxerre,6,7,7,11,-4
6,13,FC Nantes,6,6,6,8,-2
6,14,Stade de Reims,6,6,10,13,-3
6,15,Toulouse FC,6,5,7,11,-4
6,16,OGC Nice,6,5,4,8,-4
6,17,Stade Brestois 29,6,5,8,16,-8
6,18,RC Strasbourg Alsace,6,4,5,7,-2
6,19,Angers SCO,6,2,6,17,-11
6,20,AC Ajaccio,6,1,3,10,-7
7,1,Paris Saint-Germain FC,7,19,25,4,21
7,2,Olympique de Marseille,7,19,15,4,11
7,3,Racing Club de Lens,7,17,16,7,9
7,4,FC Lorient,7,16,14,11,3
7,5,Olympique Lyonnais,7,13,16,9,7
7,6,Stade Rennais FC 1901,7,11,13,7,6
7,7,AS Monaco FC,7,11,10,12,-2
7,8,Lille OSC,7,10,14,15,-1
7,9,Clermont Foot 63,7,10,8,10,-2
7,10,Montpellier HSC,7,9,17,14,3
7,11,Toulouse FC,7,8,8,11,-3
7,12,OGC Nice,7,8,5,8,-3
7,13,ES Troyes AC,7,7,11,15,-4
7,14,AJ Auxerre,7,7,7,16,-9
7,15,FC Nantes,7,6,8,11,-3
7,16,Stade de Reims,7,6,10,14,-4
7,17,RC Strasbourg Alsace,7,5,5,7,-2
7,18,Stade Brestois 29,7,5,8,17,-9
7,19,Angers SCO,7,5,8,18,-10
7,20,AC Ajaccio,7,1,3,11,-8
8,1,Paris Saint-Germain FC,8,22,26,4,22
8,2,Olympique de Marseille,8,20,16,5,11
8,3,FC Lorient,8,19,17,12,5
8,4,Racing Club de Lens,8,18,16,7,9
8,5,AS Monaco FC,8,14,13,12,1
8,6,Olympique Lyonnais,8,13,16,10,6
8,7,Lille OSC,8,13,16,16,0
8,8,Stade Rennais FC 1901,8,12,14,8,6
8,9,Montpellier HSC,8,12,19,15,4
8,10,ES Troyes AC,8,10,14,16,-2
8,11,Clermont Foot 63,8,10,9,13,-4
8,12,Toulouse FC,8,8,9,13,-4
8,13,OGC Nice,8,8,5,9,-4
8,14,Angers SCO,8,8,9,18,-9
8,15,FC Nantes,8,7,8,11,-3
8,16,AJ Auxerre,8,7,8,19,-11
8,17,Stade de Reims,8,6,10,17,-7
8,18,RC Strasbourg Alsace,8,5,6,9,-3
8,19,Stade Brestois 29,8,5,8,18,-10
8,20,AC Ajaccio,8,4,4,11,-7
9,1,Paris Saint-Germain FC,9,25,28,5,23
9,2,Olympique de Marseille,9,23,19,5,14
9,3,FC Lorient,9,22,19,13,6
9,4,Racing Club de Lens,9,21,17,7,10
9,5,AS Monaco FC,9,17,17,13,4
9,6,Stade Rennais FC 1901,9,15,17,9,8
9,7,Olympique Lyonnais,9,13,16,11,5
9,8,Lille OSC,9,13,17,18,-1
9,9,Clermont Foot 63,9,13,12,14,-2
9,10,Montpellier HSC,9,12,21,19,2
9,11,ES Troyes AC,9,11,16,18,-2
9,12,Toulouse FC,9,11,13,15,-2
9,13,OGC Nice,9,8,6,11,-5
9,14,AJ Auxerre,9,8,9,20,-11
9,15,Angers SCO,9,8,9,21,-12
9,16,FC Nantes,9,7,9,15,-6
9,17,Stade de Reims,9,7,12,19,-7
9,18,Stade Brestois 29,9,6,9,19,-10
9,19,RC Strasbourg Alsace,9,5,7,12,-5
9,20,AC Ajaccio,9,4,5,14,-9
10,1,Paris Saint-Germain FC,10,26,28,5,23
10,2,FC Lorient,10,25,21,14,7
10,3,Olympique de Marseille,10,23,20,7,13
10,4,Racing Club de Lens,10,21,17,8,9
10,5,AS Monaco FC,10,20,19,13,6
10,6,Stade Rennais FC 1901,10,18,20,9,11
10,7,Lille OSC,10,16,18,18,0
10,8,Clermont Foot 63,10,16,14,15,-1
10,9,Olympique Lyonnais,10,14,17,12,5
10,10,Montpellier HSC,10,12,21,21,0
10,11,Toulouse FC,10,12,14,16,-2
10,12,ES Troyes AC,10,11,18,21,-3
10,13,OGC Nice,10,11,9,13,-4
10,14,RC Strasbourg Alsace,10,8,10,14,-4
10,15,Stade de Reims,10,8,12,19,-7
10,16,AJ Auxerre,10,8,10,22,-12
10,17,Angers SCO,10,8,11,24,-13
10,18,AC Ajaccio,10,7,7,15,-8
10,19,FC Nantes,10,7,9,18,-9
10,20,Stade Brestois 29,10,6,10,21,-11
11,1,Paris Saint-Germain FC,11,29,29,5,24
11,2,FC Lorient,11,26,21,14,7
11,3,Racing Club de Lens,11,24,18,8,10
11,4,Olympique de Marseille,11,23,20,8,12
11,5,Stade Rennais FC 1901,11,21,23,11,12
11,6,AS Monaco FC,11,21,20,14,6
11,7,Lille OSC,11,19,21,18,3
11,8,Clermont Foot 63,11,17,15,16,-1
11,9,Toulouse FC,11,15,17,18,-1
11,10,Olympique Lyonnais,11,14,19,15,4
11,11,Montpellier HSC,11,12,21,22,-1
11,12,ES Troyes AC,11,12,19,22,-3
11,13,OGC Nice,11,12,10,14,-4
11,14,FC Nantes,11,10,13,19,-6
11,15,Stade de Reims,11,9,12,19,-7
11,16,AJ Auxerre,11,9,11,23,-12
11,17,RC Strasbourg Alsace,11,8,10,17,-7
11,18,AC Ajaccio,11,8,8,16,-8
11,19,Angers SCO,11,8,13,27,-14
11,20,Stade Brestois 29,11,6,11,25,-14
12,1,Paris Saint-Germain FC,12,32,32,5,27
12,2,Racing Club de Lens,12,27,19,8,11
12,3,FC Lorient,12,27,23,16,7
12,4,Stade Rennais FC 1901,12,24,25,12,13
12,5,Olympique de Marseille,12,23,20,9,11
12,6,Lille OSC,12,22,25,21,4
12,7,AS Monaco FC,12,21,23,18,5
12,8,Olympique Lyonnais,12,17,21,16,5
12,9,Clermont Foot 63,12,17,16,19,-3
12,10,Toulouse FC,12,16,19,20,-1
12,11,ES Troyes AC,12,13,21,24,-3
12,12,OGC Nice,12,13,11,15,-4
12,13,Montpellier HSC,12,12,22,24,-2
12,14,Stade de Reims,12,12,14,20,-6
12,15,FC Nantes,12,11,14,20,-6
12,16,RC Strasbourg Alsace,12,9,12,19,-7
12,17,Stade Brestois 29,12,9,14,26,-12
12,18,AJ Auxerre,12,9,12,25,-13
12,19,AC Ajaccio,12,8,8,19,-11
12,20,Angers SCO,12,8,14,29,-15
13,1,Paris Saint-Germain FC,13,35,36,8,28
13,2,Racing Club de Lens,13,30,22,8,14
13,3,Stade Rennais FC 1901,13,27,28,12,16
13,4,FC Lorient,13,27,24,18,6
13,5,Olympique de Marseille,13,24,22,11,11
13,6,AS Monaco FC,13,24,25,18,7
13,7,Lille OSC,13,22,25,22,3
13,8,Olympique Lyonnais,13,20,22,16,6
13,9,Clermont Foot 63,13,18,17,20,-3
13,10,OGC Nice,13,16,13,16,-3
13,11,Toulouse FC,13,16,19,23,-4
13,12,ES Troyes AC,13,13,24,28,-4
13,13,Stade de Reims,13,13,14,20,-6
13,14,Montpellier HSC,13,12,22,27,-5
13,15,FC Nantes,13,12,15,21,-6
13,16,AJ Auxerre,13,12,13,25,-12
13,17,RC Strasbourg Alsace,13,10,14,21,-7
13,18,Stade Brestois 29,13,10,14,26,-12
13,19,AC Ajaccio,13,8,8,20,-12
13,20,Angers SCO,13,8,14,31,-17
14,1,Paris Saint-Germain FC,14,38,38,9,29
14,2,Racing Club de Lens,14,33,24,9,15
14,3,Stade Rennais FC 1901,14,28,29,13,16
14,4,Olympique de Marseille,14,27,23,11,12
14,5,AS Monaco FC,14,27,27,18,9
14,6,FC Lorient,14,27,25,20,5
14,7,Lille OSC,14,23,26,23,3
14,8,Olympique Lyonnais,14,20,22,17,5
14,9,OGC Nice,14,19,14,16,-2
14,10,Clermont Foot 63,14,19,18,21,-3
14,11,Stade de Reims,14,16,15,20,-5
14,12,Toulouse FC,14,16,19,25,-6
14,13,ES Troyes AC,14,14,25,29,-4
14,14,Montpellier HSC,14,13,23,28,-5
14,15,AJ Auxerre,14,13,14,26,-12
14,16,FC Nantes,14,12,15,22,-7
14,17,AC Ajaccio,14,11,12,22,-10
14,18,RC Strasbourg Alsace,14,10,16,25,-9
14,19,Stade Brestois 29,14,10,14,27,-13
14,20,Angers SCO,14,8,15,33,-18
15,1,Paris Saint-Germain FC,15,41,43,9,34
15,2,Racing Club de Lens,15,36,26,10,16
15,3,Stade Rennais FC 1901,15,31,31,14,17
15,4,Olympique de Marseille,15,30,26,13,13
15,5,FC Lorient,15,28,26,21,5
15,6,AS Monaco FC,15,27,29,21,8
15,7,Lille OSC,15,26,27,23,4
15,8,Olympique Lyonnais,15,21,23,18,5
15,9,OGC Nice,15,20,15,17,-2
15,10,Clermont Foot 63,15,19,19,23,-4
15,11,Stade de Reims,15,17,16,21,-5
15,12,Toulouse FC,15,16,20,27,-7
15,13,ES Troyes AC,15,14,26,31,-5
15,14,Montpellier HSC,15,14,24,29,-5
15,15,FC Nantes,15,13,17,24,-7
15,16,Stade Brestois 29,15,13,16,28,-12
15,17,AJ Auxerre,15,13,14,31,-17
15,18,AC Ajaccio,15,12,14,24,-10
15,19,RC Strasbourg Alsace,15,11,17,26,-9
15,20,Angers SCO,15,8,15,34,-19
16,1,Paris Saint-Germain FC,16,44,45,10,35
16,2,Racing Club de Lens,16,37,26,10,16
16,3,Olympique de Marseille,16,33,32,14,18
16,4,Stade Rennais FC 1901,16,31,32,17,15
16,5,AS Monaco FC,16,30,32,23,9
16,6,Lille OSC,16,29,29,23,6
16,7,FC Lorient,16,28,26,23,3
16,8,Olympique Lyonnais,16,24,27,20,7
16,9,OGC Nice,16,21,15,17,-2
16,10,Stade de Reims,16,20,19,22,-3
16,11,Clermont Foot 63,16,19,19,25,-6
16,12,Montpellier HSC,16,17,26,29,-3
16,13,Toulouse FC,16,16,21,33,-12
16,14,ES Troyes AC,16,15,26,31,-5
16,15,AC Ajaccio,16,15,15,24,-9
16,16,FC Nantes,16,14,17,24,-7
16,17,Stade Brestois 29,16,13,18,32,-14
16,18,AJ Auxerre,16,13,16,34,-18
16,19,RC Strasbourg Alsace,16,11,18,28,-10
16,20,Angers SCO,16,8,15,35,-20
17,1,Paris Saint-Germain FC,17,44,46,13,33
17,2,Racing Club de Lens,17,40,29,11,18
17,3,Olympique de Marseille,17,36,34,15,19
17,4,Stade Rennais FC 1901,17,34,34,18,16
17,5,AS Monaco FC,17,33,33,23,10
17,6,FC Lorient,17,31,28,24,4
17,7,Lille OSC,17,30,30,24,6
17,8,Olympique Lyonnais,17,24,27,21,6
17,9,Clermont Foot 63,17,22,20,25,-5
17,10,Stade de Reims,17,21,20,23,-3
17,11,OGC Nice,17,21,16,19,-3
17,12,Toulouse FC,17,19,23,33,-10
17,13,ES Troyes AC,17,18,29,33,-4
17,14,Montpellier HSC,17,17,27,31,-4
17,15,FC Nantes,17,17,18,24,-6
17,16,AC Ajaccio,17,15,15,26,-11
17,17,Stade Brestois 29,17,13,18,33,-15
17,18,AJ Auxerre,17,13,16,35,-19
17,19,RC Strasbourg Alsace,17,11,20,31,-11
17,20,Angers SCO,17,8,16,37,-21
18,1,Paris Saint-Germain FC,18,47,48,13,35
18,2,Racing Club de Lens,18,41,31,13,18
18,3,Olympique de Marseille,18,39,36,15,21
18,4,Stade Rennais FC 1901,18,34,35,20,15
18,5,AS Monaco FC,18,34,35,25,10
18,6,FC Lorient,18,32,30,26,4
18,7,Lille OSC,18,31,30,24,6
18,8,Olympique Lyonnais,18,25,27,21,6
18,9,Clermont Foot 63,18,25,22,26,-4
18,10,OGC Nice,18,24,22,20,2
18,11,Stade de Reims,18,24,21,23,-2
18,12,Toulouse FC,18,22,28,33,-5
18,13,ES Troyes AC,18,18,29,35,-6
18,14,FC Nantes,18,18,18,24,-6
18,15,Montpellier HSC,18,17,28,37,-9
18,16,AC Ajaccio,18,15,15,27,-12
18,17,Stade Brestois 29,18,14,18,33,-15
18,18,AJ Auxerre,18,13,16,40,-24
18,19,RC Strasbourg Alsace,18,12,22,33,-11
18,20,Angers SCO,18,8,16,39,-23
19,1,Paris Saint-Germain FC,19,47,48,14,34
19,2,Racing Club de Lens,19,44,32,13,19
19,3,Olympique de Marseille,19,42,39,16,23
19,4,AS Monaco FC,19,37,42,26,16
19,5,Stade Rennais FC 1901,19,37,36,20,16
19,6,Lille OSC,19,34,35,25,10
19,7,FC Lorient,19,32,31,29,2
19,8,Clermont Foot 63,19,28,24,27,-3
19,9,Olympique Lyonnais,19,25,28,23,5
19,10,OGC Nice,19,25,22,20,2
19,11,Stade de Reims,19,25,21,23,-2
19,12,Toulouse FC,19,23,29,34,-5
19,13,FC Nantes,19,21,21,24,-3
19,14,ES Troyes AC,19,18,30,40,-10
19,15,Montpellier HSC,19,17,28,40,-12
19,16,RC Strasbourg Alsace,19,15,24,34,-10
19,17,Stade Brestois 29,19,15,19,34,-15
19,18,AC Ajaccio,19,15,16,34,-18
19,19,AJ Auxerre,19,13,16,41,-25
19,20,Angers SCO,19,8,17,41,-24
20,1,Paris Saint-Germain FC,20,48,49,15,34
20,2,Racing Club de Lens,20,45,33,14,19
20,3,Olympique de Marseille,20,43,40,17,23
20,4,AS Monaco FC,20,38,43,27,16
20,5,Stade Rennais FC 1901,20,37,37,22,15
20,6,FC Lorient,20,35,33,30,3
20,7,Lille OSC,20,34,35,26,9
20,8,Clermont Foot 63,20,29,24,27,-3
20,9,Olympique Lyonnais,20,28,30,23,7
20,10,OGC Nice,20,28,23,20,3
20,11,Stade de Reims,20,26,22,24,-2
20,12,Toulouse FC,20,26,31,35,-4
20,13,FC Nantes,20,22,21,24,-3
20,14,Montpellier HSC,20,20,30,40,-10
20,15,ES Troyes AC,20,19,31,41,-10
20,16,Stade Brestois 29,20,18,23,34,-11
20,17,RC Strasbourg Alsace,20,15,25,36,-11
20,18,AC Ajaccio,20,15,16,36,-20
20,19,AJ Auxerre,20,13,16,43,-27
20,20,Angers SCO,20,8,17,45,-28
21,1,Paris Saint-Germain FC,21,51,52,16,36
21,2,Olympique de Marseille,21,46,42,17,25
21,3,Racing Club de Lens,21,45,33,15,18
21,4,AS Monaco FC,21,41,46,29,17
21,5,Stade Rennais FC 1901,21,40,40,22,18
21,6,Lille OSC,21,35,35,26,9
21,7,FC Lorient,21,35,35,34,1
21,8,OGC Nice,21,31,24,20,4
21,9,Clermont Foot 63,21,30,24,27,-3
21,10,Olympique Lyonnais,21,29,30,23,7
21,11,Stade de Reims,21,29,26,26,0
21,12,Toulouse FC,21,29,35,36,-1
21,13,FC Nantes,21,22,21,26,-5
21,14,Montpellier HSC,21,20,31,43,-12
21,15,Stade Brestois 29,21,19,23,34,-11
21,16,ES Troyes AC,21,19,32,45,-13
21,17,AC Ajaccio,21,18,18,37,-19
21,18,RC Strasbourg Alsace,21,15,25,39,-14
21,19,AJ Auxerre,21,13,18,46,-28
21,20,Angers SCO,21,8,18,47,-29
22,1,Paris Saint-Germain FC,22,54,54,17,37
22,2,Olympique de Marseille,22,46,43,20,23
22,3,Racing Club de Lens,22,46,34,16,18
22,4,AS Monaco FC,22,44,48,29,19
22,5,Stade Rennais FC 1901,22,40,41,25,16
22,6,Lille OSC,22,38,38,27,11
22,7,FC Lorient,22,36,35,34,1
22,8,OGC Nice,22,34,27,21,6
22,9,Olympique Lyonnais,22,32,33,24,9
22,10,Stade de Reims,22,30,26,26,0
22,11,Clermont Foot 63,22,30,24,29,-5
22,12,Toulouse FC,22,29,36,38,-2
22,13,FC Nantes,22,25,23,26,-3
22,14,Stade Brestois 29,22,20,24,35,-11
22,15,Montpellier HSC,22,20,31,45,-14
22,16,ES Troyes AC,22,19,33,48,-15
22,17,RC Strasbourg Alsace,22,18,27,39,-12
22,18,AC Ajaccio,22,18,18,39,-21
22,19,AJ Auxerre,22,14,18,46,-28
22,20,Angers SCO,22,9,18,47,-29
23,1,Paris Saint-Germain FC,23,54,55,20,35
23,2,Olympique de Marseille,23,49,45,20,25
23,3,AS Monaco FC,23,47,51,30,21
23,4,Racing Club de Lens,23,46,35,18,17
23,5,Lille OSC,23,41,40,27,13
23,6,Stade Rennais FC 1901,23,40,42,28,14
23,7,OGC Nice,23,37,30,21,9
23,8,FC Lorient,23,36,35,35,0
23,9,Olympique Lyonnais,23,35,35,25,10
23,10,Stade de Reims,23,33,30,26,4
23,11,Toulouse FC,23,32,39,39,0
23,12,Clermont Foot 63,23,30,24,31,-7
23,13,FC Nantes,23,28,24,26,-2
23,14,Montpellier HSC,23,23,34,45,-11
23,15,Stade Brestois 29,23,20,24,38,-14
23,16,ES Troyes AC,23,19,33,52,-19
23,17,RC Strasbourg Alsace,23,18,27,41,-14
23,18,AC Ajaccio,23,18,18,42,-24
23,19,AJ Auxerre,23,15,19,47,-28
23,20,Angers SCO,23,10,19,48,-29
24,1,Paris Saint-Germain FC,24,57,59,23,36
24,2,Olympique de Marseille,24,52,48,22,26
24,3,AS Monaco FC,24,50,53,31,22
24,4,Racing Club de Lens,24,49,38,19,19
24,5,Stade Rennais FC 1901,24,43,44,28,16
24,6,Lille OSC,24,41,43,31,12
24,7,FC Lorient,24,39,38,35,3
24,8,OGC Nice,24,38,30,21,9
24,9,Olympique Lyonnais,24,35,36,27,9
24,10,Stade de Reims,24,34,30,26,4
24,11,Toulouse FC,24,32,41,42,-1
24,12,Clermont Foot 63,24,30,24,33,-9
24,13,FC Nantes,24,28,25,29,-4
24,14,Montpellier HSC,24,26,35,45,-10
24,15,RC Strasbourg Alsace,24,21,29,42,-13
24,16,Stade Brestois 29,24,20,25,40,-15
24,17,ES Troyes AC,24,19,33,53,-20
24,18,AJ Auxerre,24,18,21,48,-27
24,19,AC Ajaccio,24,18,18,45,-27
24,20,Angers SCO,24,10,20,50,-30
25,1,Paris Saint-Germain FC,25,60,62,23,39
25,2,Olympique de Marseille,25,52,48,25,23
25,3,AS Monaco FC,25,50,53,34,19
25,4,Racing Club de Lens,25,50,39,20,19
25,5,Stade Rennais FC 1901,25,46,45,28,17
25,6,Lille OSC,25,44,45,32,13
25,7,OGC Nice,25,41,33,21,12
25,8,FC Lorient,25,39,38,36,2
25,9,Olympique Lyonnais,25,38,39,28,11
25,10,Stade de Reims,25,37,33,26,7
25,11,Toulouse FC,25,32,41,45,-4
25,12,Clermont Foot 63,25,31,25,34,-9
25,13,FC Nantes,25,28,25,30,-5
25,14,Montpellier HSC,25,27,36,46,-10
25,15,RC Strasbourg Alsace,25,22,30,43,-13
25,16,AJ Auxerre,25,21,22,48,-26
25,17,AC Ajaccio,25,21,20,46,-26
25,18,Stade Brestois 29,25,20,26,42,-16
25,19,ES Troyes AC,25,19,34,55,-21
25,20,Angers SCO,25,10,21,53,-32
26,1,Paris Saint-Germain FC,26,63,66,25,41
26,2,Olympique de Marseille,26,55,49,25,24
26,3,AS Monaco FC,26,51,55,36,19
26,4,Racing Club de Lens,26,51,40,21,19
26,5,Stade Rennais FC 1901,26,46,45,29,16
26,6,Lille OSC,26,45,46,33,13
26,7,OGC Nice,26,42,34,22,12
26,8,Stade de Reims,26,40,34,26,8
26,9,FC Lorient,26,40,38,36,2
26,10,Olympique Lyonnais,26,39,39,28,11
26,11,Clermont Foot 63,26,34,26,34,-8
26,12,Toulouse FC,26,32,41,46,-5
26,13,Montpellier HSC,26,30,41,46,-5
26,14,FC Nantes,26,28,27,34,-7
26,15,Stade Brestois 29,26,23,27,42,-15
26,16,RC Strasbourg Alsace,26,22,30,44,-14
26,17,AJ Auxerre,26,22,23,49,-26
26,18,AC Ajaccio,26,21,20,47,-27
26,19,ES Troyes AC,26,20,36,57,-21
26,20,Angers SCO,26,10,21,58,-37
27,1,Paris Saint-Germain FC,27,66,68,26,42
27,2,Olympique de Marseille,27,56,51,27,24
27,3,Racing Club de Lens,27,54,44,21,23
27,4,AS Monaco FC,27,51,55,37,18
27,5,Stade Rennais FC 1901,27,47,45,29,16
27,6,Lille OSC,27,46,49,36,13
27,7,OGC Nice,27,43,36,24,12
27,8,Stade de Reims,27,43,35,26,9
27,9,FC Lorient,27,43,40,36,4
27,10,Olympique Lyonnais,27,40,42,31,11
27,11,Toulouse FC,27,35,43,46,-3
27,12,Clermont Foot 63,27,34,26,38,-12
27,13,Montpellier HSC,27,33,42,46,-4
27,14,FC Nantes,27,29,29,36,-7
27,15,RC Strasbourg Alsace,27,23,32,46,-14
27,16,Stade Brestois 29,27,23,28,44,-16
27,17,AJ Auxerre,27,23,23,49,-26
27,18,AC Ajaccio,27,21,20,48,-28
27,19,ES Troyes AC,27,20,36,59,-23
27,20,Angers SCO,27,10,21,60,-39
28,1,Paris Saint-Germain FC,28,66,68,28,40
28,2,Olympique de Marseille,28,59,53,28,25
28,3,Racing Club de Lens,28,57,47,21,26
28,4,AS Monaco FC,28,54,57,37,20
28,5,Stade Rennais FC 1901,28,50,47,29,18
28,6,Lille OSC,28,49,51,36,15
28,7,OGC Nice,28,44,37,25,12
28,8,FC Lorient,28,44,41,37,4
28,9,Stade de Reims,28,43,36,28,8
28,10,Olympique Lyonnais,28,41,43,32,11
28,11,Montpellier HSC,28,36,44,47,-3
28,12,Toulouse FC,28,35,43,48,-5
28,13,Clermont Foot 63,28,34,27,40,-13
28,14,FC Nantes,28,30,30,37,-7
28,15,RC Strasbourg Alsace,28,26,34,46,-12
28,16,Stade Brestois 29,28,24,30,46,-16
28,17,AJ Auxerre,28,23,23,51,-28
28,18,ES Troyes AC,28,21,38,61,-23
28,19,AC Ajaccio,28,21,20,50,-30
28,20,Angers SCO,28,10,21,63,-42
29,1,Paris Saint-Germain FC,29,66,68,29,39
29,2,Racing Club de Lens,29,60,48,21,27
29,3,Olympique de Marseille,29,60,54,29,25
29,4,AS Monaco FC,29,57,61,40,21
29,5,Lille OSC,29,52,54,37,17
29,6,Stade Rennais FC 1901,29,50,47,30,17
29,7,Stade de Reims,29,46,39,28,11
29,8,OGC Nice,29,45,38,26,12
29,9,Olympique Lyonnais,29,44,44,32,12
29,10,FC Lorient,29,44,42,40,2
29,11,Montpellier HSC,29,37,45,48,-3
29,12,Clermont Foot 63,29,37,29,41,-12
29,13,Toulouse FC,29,35,44,51,-7
29,14,FC Nantes,29,30,30,40,-10
29,15,Stade Brestois 29,29,27,33,47,-14
29,16,RC Strasbourg Alsace,29,26,37,50,-13
29,17,AJ Auxerre,29,26,24,51,-27
29,18,ES Troyes AC,29,21,38,62,-24
29,19,AC Ajaccio,29,21,21,52,-31
29,20,Angers SCO,29,11,22,64,-42
30,1,Paris Saint-Germain FC,30,69,70,29,41
30,2,Racing Club de Lens,30,63,50,22,28
30,3,Olympique de Marseille,30,61,54,29,25
30,4,AS Monaco FC,30,58,63,42,21
30,5,Lille OSC,30,52,54,38,16
30,6,Stade Rennais FC 1901,30,50,48,33,15
30,7,Olympique Lyonnais,30,47,47,33,14
30,8,Stade de Reims,30,47,40,29,11
30,9,OGC Nice,30,45,38,28,10
30,10,FC Lorient,30,45,42,40,2
30,11,Clermont Foot 63,30,40,31,41,-10
30,12,Toulouse FC,30,38,46,52,-6
30,13,Montpellier HSC,30,37,46,50,-4
30,14,FC Nantes,30,31,32,42,-10
30,15,AJ Auxerre,30,29,27,51,-24
30,16,Stade Brestois 29,30,28,34,48,-14
30,17,RC Strasbourg Alsace,30,26,38,52,-14
30,18,ES Troyes AC,30,21,38,64,-26
30,19,AC Ajaccio,30,21,21,55,-34
30,20,Angers SCO,30,14,23,64,-41
31,1,Paris Saint-Germain FC,31,72,73,30,43
31,2,Olympique de Marseille,31,64,57,30,27
31,3,Racing Club de Lens,31,63,51,25,26
31,4,AS Monaco FC,31,61,66,43,23
31,5,Lille OSC,31,55,56,39,17
31,6,Stade Rennais FC 1901,31,53,51,33,18
31,7,Olympique Lyonnais,31,50,49,34,15
31,8,Stade de Reims,31,47,40,32,8
31,9,OGC Nice,31,45,38,29,9
31,10,FC Lorient,31,45,43,43,0
31,11,Clermont Foot 63,31,43,33,42,-9
31,12,Toulouse FC,31,38,47,54,-7
31,13,Montpellier HSC,31,37,47,52,-5
31,14,AJ Auxerre,31,32,29,52,-23
31,15,FC Nantes,31,31,33,44,-11
31,16,Stade Brestois 29,31,31,35,48,-13
31,17,RC Strasbourg Alsace,31,29,41,53,-12
31,18,ES Troyes AC,31,21,39,67,-28
31,19,AC Ajaccio,31,21,22,58,-36
31,20,Angers SCO,31,14,24,66,-42
32,1,Paris Saint-Germain FC,32,75,75,31,44
32,2,Olympique de Marseille,32,67,59,31,28
32,3,Racing Club de Lens,32,66,54,25,29
32,4,AS Monaco FC,32,61,66,46,20
32,5,Lille OSC,32,56,57,40,17
32,6,Stade Rennais FC 1901,32,53,51,34,17
32,7,Olympique Lyonnais,32,50,50,36,14
32,8,Stade de Reims,32,47,40,34,6
32,9,Clermont Foot 63,32,46,35,43,-8
32,10,OGC Nice,32,45,39,31,8
32,11,FC Lorient,32,45,43,44,-1
32,12,Toulouse FC,32,41,48,54,-6
32,13,Montpellier HSC,32,40,48,52,-4
32,14,AJ Auxerre,32,33,30,53,-23
32,15,RC Strasbourg Alsace,32,32,43,53,-10
32,16,FC Nantes,32,32,35,46,-11
32,17,Stade Brestois 29,32,32,35,48,-13
32,18,ES Troyes AC,32,22,41,69,-28
32,19,AC Ajaccio,32,22,22,58,-36
32,20,Angers SCO,32,14,25,68,-43
33,1,Paris Saint-Germain FC,33,75,76,34,42
33,2,Olympique de Marseille,33,70,61,32,29
33,3,Racing Club de Lens,33,69,55,25,30
33,4,AS Monaco FC,33,61,66,50,16
33,5,Lille OSC,33,59,60,40,20
33,6,Stade Rennais FC 1901,33,56,55,36,19
33,7,Olympique Lyonnais,33,53,52,37,15
33,8,Clermont Foot 63,33,49,36,43,-7
33,9,OGC Nice,33,48,40,31,9
33,10,FC Lorient,33,48,46,45,1
33,11,Stade de Reims,33,47,40,35,5
33,12,Montpellier HSC,33,43,52,52,0
33,13,Toulouse FC,33,41,48,55,-7
33,14,Stade Brestois 29,33,35,37,48,-11
33,15,AJ Auxerre,33,33,31,55,-24
33,16,RC Strasbourg Alsace,33,32,44,55,-11
33,17,FC Nantes,33,32,35,48,-13
33,18,ES Troyes AC,33,22,41,70,-29
33,19,AC Ajaccio,33,22,22,61,-39
33,20,Angers SCO,33,14,27,72,-45
34,1,Paris Saint-Germain FC,34,78,79,35,44
34,2,Racing Club de Lens,34,72,57,26,31
34,3,Olympique de Marseille,34,70,62,34,28
34,4,AS Monaco FC,34,64,68,51,17
34,5,Lille OSC,34,59,60,41,19
34,6,Stade Rennais FC 1901,34,56,56,38,18
34,7,Olympique Lyonnais,34,56,57,41,16
34,8,OGC Nice,34,51,42,32,10
34,9,FC Lorient,34,51,48,46,2
34,10,Stade de Reims,34,50,41,35,6
34,11,Clermont Foot 63,34,50,37,44,-7
34,12,Montpellier HSC,34,43,56,57,-1
34,13,Toulouse FC,34,42,48,55,-7
34,14,RC Strasbourg Alsace,34,35,46,55,-9
34,15,Stade Brestois 29,34,35,38,50,-12
34,16,AJ Auxerre,34,34,32,56,-24
34,17,FC Nantes,34,32,35,50,-15
34,18,AC Ajaccio,34,23,22,61,-39
34,19,ES Troyes AC,34,22,42,73,-31
34,20,Angers SCO,34,14,28,74,-46
